b 0 0 0 0 
W 1 0 1 0 
o 2 0 0 0 
V 3 0 0 0 
* 4 0 0 0 
L 0 1 0 0 
_ 1 1 0 0 
R 2 1 0 0 
F 3 1 0 1 
Q 4 1 0 1 
K 0 2 0 1 
^ 1 2 0 1 
D 2 2 0 1
T 3 2 0 1
E 3 3 0 0