1 0 0 1 0 
W 1 0 1 0 
B 2 0 0 1 
[ 3 0 1 0
] 4 0 1 0 
L 0 1 1 0 
_ 1 1 1 0 
R 2 1 1 0 
F 3 1 0 0 
Q 4 1 0 0 
K 0 2 0 0 
^ 1 2 0 0 
D 2 2 0 0
T 3 2 1 0
S 3 3 0 0